顺丰 科技	顺丰 科技 简介
顺丰 科技 有限公司	顺丰 科技 简介
顺丰 科技 是 家 什么样 的 公司	顺丰 科技 简介
顺丰 科技 是 什么 公司	顺丰 科技 简介
顺丰 科技 资料	顺丰 科技 简介
顺丰 科技 简介	顺丰 科技 简介
顺丰 科技 介绍	顺丰 科技 简介
顺丰 科技 和顺 丰速运 的 关系	顺丰 科技 和顺 丰速运 的 关系
顺丰 科技 属于 顺丰 集团 吗	顺丰 科技 和顺 丰速运 的 关系
顺丰 科技 和顺 丰速 运有 啥 关系	顺丰 科技 和顺 丰速运 的 关系
顺丰 科技 与 顺丰 咨询	顺丰 咨询 是 做 什么 的
顺丰 咨询 是 做 什么 的	顺丰 咨询 是 做 什么 的
顺丰 科技 公司 在 哪儿	顺丰 科技 地址
顺丰 科技 在 哪 上班	顺丰 科技 地址
顺丰 科技 办公 环境	顺丰 科技 地址
顺丰 科技 办公 地点	顺丰 科技 地址
工作 地点	顺丰 科技 地址
上班时间	弹性 工作制
下班时间	弹性 工作制
工作 时间	弹性 工作制
弹性 工作制	弹性 工作制
休假 制度	休假 制度
休假 安排	休假 制度
假期 情况	休假 制度
顺丰 科技 公司 附近 地铁 、 公交	公司 附近 交通
顺丰 科技 公司 交通 便利 吗	公司 附近 交通
顺丰 科技 公司 最近 的 地铁站	公司 附近 交通
顺丰 科技人员 规模	顺丰 科技 公司 规模
顺丰 科技 公司 规模	顺丰 科技 公司 规模
顺丰 科技 团队 规模	顺丰 科技 公司 规模
顺丰 科技 研发 团队	顺丰 科技 公司 规模
顺丰 科技 规模	顺丰 科技 公司 规模
顺丰 科技 目前 有 多少 人	顺丰 科技 公司 规模
顺丰 科技 有 多少 技术人员	顺丰 科技 公司 规模
顺丰 科技 怎么样	顺丰 科技 实力
顺丰 科技 实力	顺丰 科技 实力
顺丰 科技 如何	顺丰 科技 实力
顺丰 科技 的 技术水平	顺丰 科技 实力
顺丰 科技 研发 实力	顺丰 科技 实力
顺丰 科技 业务	顺丰 科技 实力
顺丰 科技 发展	顺丰 科技 发展
顺丰 科技 的 前景	顺丰 科技 发展
顺丰 科技 未来 发展	顺丰 科技 发展
顺丰 科技 ceo	顺丰 科技 总裁
顺丰 科技 总裁	顺丰 科技 总裁
田民	顺丰 科技 总裁
顺丰 科技 上市 了 吗	顺丰 科技 股票
顺丰 科技 股票	顺丰 科技 股票
顺丰 科技 员工 配股 吗	顺丰 科技 股票
顺丰 科技 在 深圳 工资	顺丰 科技 薪资 待遇
顺丰 科技 薪资	顺丰 科技 薪资 待遇
顺丰 科技 待遇 怎么样	顺丰 科技 薪资 待遇
顺丰 科技 级别 与 薪资	顺丰 科技 薪资 待遇
薪酬 福利	顺丰 科技 薪资 待遇
顺丰 科技 项目 奖金	顺丰 科技 年终奖
顺丰 科技 年终奖 多 吗	顺丰 科技 年终奖
顺丰 科技 年终奖	顺丰 科技 年终奖
顺丰 科技 年终奖 能发 多少	顺丰 科技 年终奖
智慧 物流 是 什么	顺丰 科技 智慧 物流
顺丰 科技 智慧 物流	顺丰 科技 智慧 物流
顺丰 科技 智慧 物流 有些 方面	顺丰 科技 智慧 物流
顺丰 科技 文化氛围	顺丰 科技 文化
顺丰 科技 工作 氛围	顺丰 科技 文化
顺丰 科技 文化	顺丰 科技 文化
顺丰 科技 文化 价值观	顺丰 科技 文化
顺丰 科技 企业 价值观	顺丰 科技 文化
是否 需要 经常 加班	加班 情况
加班 严重 吗	加班 情况
需要 经常 加班 吗	加班 情况
几点 下班	加班 情况
公司 签 多长时间 的 劳动合同 ？	合同 年限
合同 签 多久	合同 年限
合同 几年	合同 年限
合同 年限	合同 年限
公司 社保 和 公积金	社保 和 公积金
五险 一金 缴纳 标准	社保 和 公积金
公司 的 调薪 机制 是 怎样 的 ？	调薪
校招 启动 时间	校招 开始 时间
校招 开始 时间	校招 开始 时间
海外 校招 开始 时间 及 行程 安排	海外 校招
海外 招聘 行程	海外 校招
海外 校招 城市	海外 校招
校招 结束 时间	校招 结束 时间
顺丰 科技 招聘 公众 号	顺丰 科技 微信 公众 号
校招 微信 公众 号 是 什么	顺丰 科技 微信 公众 号
校招 网站	顺丰 科技 招聘 网站
校招 官网	顺丰 科技 招聘 网站
顺丰 科技 招聘 网站	顺丰 科技 招聘 网站
顺丰 科技 校招 联系人	校招 工作人员 邮箱
怎么 联系 校招 工作人员	校招 工作人员 邮箱
校招 工作人员 联系方式	校招 工作人员 邮箱
校园 招聘 行程	校园 招聘 行程 安排
校招会 去 哪些 城市	校园 招聘 行程 安排
校园 招聘 城市	校园 招聘 行程 安排
校招会 去 哪些地方	校园 招聘 行程 安排
校招 线路 和 时间	校园 招聘 行程 安排
今年 的 校招 路线 安排	校园 招聘 行程 安排
校招 招聘 职位 有 哪些	校招 岗位
校招 所有 岗位	校招 岗位
校招 岗位 有 哪些	校招 岗位
校招 有 哪些 岗位	校招 岗位
校招 岗位 招聘 多少 人	校招 招聘 人数
校招 岗位 招聘 人数	校招 招聘 人数
校招 岗位 需求 数量	校招 招聘 人数
今年 校 招招 多少 人	校招 招聘 人数
这个 岗位 什么 专业 可以 申请	校园 招聘 岗位 专业 要求
岗位 是否 限定 专业	校园 招聘 岗位 专业 要求
非 相关 专业 可以 申请 吗	校园 招聘 岗位 专业 要求
岗位 专业 要求	校园 招聘 岗位 专业 要求
校招 学历 要求	岗位 学历 要求
三本 学历 有 影响 吗	岗位 学历 要求
非 宣讲 院校 学生 影响 吗	岗位 学历 要求
非 211 / 985 院校 可以 投递 吗	岗位 学历 要求
双非 学校 有 影响 吗	岗位 学历 要求
双非 学校 有 机会 吗	岗位 学历 要求
是否 接受 非 应届生 投递	校招 非 应届 可以 投递 吗
非 应届生 可以 投递 吗	校招 非 应届 可以 投递 吗
是否 接受 往届生 投递	校招 非 应届 可以 投递 吗
非 应届生 可以 申请 吗	校招 非 应届 可以 投递 吗
应届生 毕业 时间	应届生 界定
海外 应届生 毕业 时间	应届生 界定
怎么 界定 应届生	应届生 界定
什么 时候 毕业 算 应届生	应届生 界定
是否 有 性别歧视	岗位 性别歧视
是否 有 限定 性别	岗位 性别歧视
某些 岗位 是否 不招 女生	岗位 性别歧视
某 岗位 是否 只招 男生	岗位 性别歧视
校园 招聘 宣讲 院校	校园 招聘 宣讲 院校 行程 安排
校招会 在 哪些 院校 宣讲	校园 招聘 宣讲 院校 行程 安排
宣讲会 时间 安排	校园 招聘 宣讲 院校 行程 安排
宣讲会 行程	校园 招聘 宣讲 院校 行程 安排
宣讲会 地点	校园 招聘 宣讲 院校 行程 安排
宣讲会 现场 是否 接收 简历	宣讲会 现场 是否 接收 简历
宣讲会 可以 投 简历 吗	宣讲会 现场 是否 接收 简历
宣讲会 现场 收 简历 吗	宣讲会 现场 是否 接收 简历
简历 投递 地址	校招 网申 地址
简历 投递 网站	校招 网申 地址
校招 网申 地址	校招 网申 地址
校招 网申 链接	校招 网申 地址
校招 怎么 网申	校招 网申 地址
校招 怎么 投递 简历	校招 网申 地址
校招 网申 途径	校招 网申 地址
网申 通道	校招 网申 地址
校招 简历 投递 渠道	校招 网申 地址
校招 简历 投递 途径	校招 网申 地址
校招 可以 投递 几个 岗位	校招 岗位 投递 数量
校招 岗位 投递 数量	校招 岗位 投递 数量
校招 岗位 数量 有 限制 吗	校招 岗位 投递 数量
最 多 可以 申请 几个 岗位	校招 岗位 投递 数量
一个 人 可以 申 几个 岗位	校招 岗位 投递 数量
可以 同时 投递 几个 岗位	校招 岗位 投递 数量
可以 申请 几个 职位	校招 岗位 投递 数量
网申 开始 时间	校招 网申 开始 时间
什么 时候 可以 网申	校招 网申 开始 时间
网申 什么 时候 结束	校招 网申 结束 时间
简历 投递 结束 日期	校招 网申 结束 时间
网申 截止 时间	校招 网申 结束 时间
校招 还 可以 投 简历 吗	校招 网申 结束 时间
简历 投递 截止 日期	校招 网申 结束 时间
校招 网申 截止 日期	校招 网申 结束 时间
还 可以 网申 吗	校招 网申 结束 时间
还 可以 投 简历 吗	校招 网申 结束 时间
网申 测评 成绩	网申 测评 成绩
在线 测评 成绩 影响 简历 筛选 吗	网申 测评 成绩
网申 测评 对 面试 有 影响 吗	网申 测评 成绩
必须 做 网申 测评 吗	网申 测评 成绩
网申 测评 成绩 重要 吗	网申 测评 成绩
网申 遇到 问题 怎么办	校招 网申 遇到 问题 反馈 渠道
网申 提交 不了 怎么办	校招 网申 遇到 问题 反馈 渠道
网申 不了 怎么办	校招 网申 遇到 问题 反馈 渠道
测评 提交 不了	校招 网申 遇到 问题 反馈 渠道
有 问题 怎么 反馈	校招 网申 遇到 问题 反馈 渠道
简历 筛选 的 标准	简历 筛选 的 标准
简历 筛选 会 看 专业 吗	简历 筛选 的 标准
简历 筛选 会 有 专业 限制 吗	简历 筛选 的 标准
简历 筛选 比例	简历 筛选 比例
简历 筛选 什么 时候 结束	简历 筛选 什么 时候 出 结果
简历 筛选 什么 时候 出 结果	简历 筛选 什么 时候 出 结果
什么 岗位 需要 笔试	校招 笔试 岗位
需要 参加 笔试 的 岗位	校招 笔试 岗位
校招 笔试 岗位 有 哪些	校招 笔试 岗位
职能 类 岗位 需要 笔试 吗	校招 笔试 岗位
校招 笔试 内容	校招 笔试 的 内容
校招 笔试 考 什么	校招 笔试 的 内容
笔试 难 吗	校招 笔试 的 内容
笔试 时间	笔试 时间
笔试 通知 什么 时候 发	笔试 时间
笔试 方式	校招 笔试 方式
笔试 是 在线 上 还是 线下	校招 笔试 方式
笔试 结果 什么 时候 出	笔试 结果 反馈 时间
笔试 反馈 时间	笔试 结果 反馈 时间
面试 流程	校园 招聘 的 面试 流程 是 什么
面试 一共 有 几轮	校园 招聘 的 面试 流程 是 什么
校招 一共 面 几轮	校园 招聘 的 面试 流程 是 什么
错过 笔试 ， 可以 面试 吗	校招 接受 霸面 吗 ？
忘记 笔试 可以 面试 吗	校招 接受 霸面 吗 ？
忘记 笔试 可以 霸面 吗	校招 接受 霸面 吗 ？
可以 霸面 吗	校招 接受 霸面 吗 ？
接受 霸面 吗	校招 接受 霸面 吗 ？
面试 通知 什么 时候 发	面试 通知 时间
什么 时候 给 面试 通知	面试 通知 时间
开始 面试 了 吗	面试 通知 时间
校招 面试 要 携带 的 资料	面试 环节 还 需要 提供 哪些 资料 、 证件 ?
校招 面试 要 带 什么	面试 环节 还 需要 提供 哪些 资料 、 证件 ?
面试 资料	面试 环节 还 需要 提供 哪些 资料 、 证件 ?
可以 更改 面试 地点 吗	校招 面试 地点
可以 换 面试 城市 吗	校招 面试 地点
面试 结果 什么 时候 给	面试 结果 什么 时候 通知
什么 时候 有 面试 结果	面试 结果 什么 时候 通知
如何 查询 面试 结果	面试 结果 什么 时候 通知
面试 不 通过 会 通知 吗	面试 结果 什么 时候 通知
面试 通过 后 几天 给 通知	面试 结果 什么 时候 通知
校招 面试 结束 了 吗	面试 结果 什么 时候 通知
什么 时候 给 面试 通知	面试 结果 什么 时候 通知
什么 时候 发 offer	校招 offer 时间
offer 发了 吗	校招 offer 时间
毁约 流程	毁约 流程
签 三方 后 ， 违约 怎么 处理	毁约 流程
offer 沟通 会 必须 参加 吗	毁约 流程
三方 邮寄 地址	公司 联系人 及 电话 、 地址 ( 三方 接收 人 )
三方 接收 人	公司 联系人 及 电话 、 地址 ( 三方 接收 人 )
三方 什么 时候 寄回	三方 寄回 时间
三方 寄回 时间	三方 寄回 时间
公司 全称	公司 全称
公司地址	顺丰 科技 地址
顺丰 科技 地址	顺丰 科技 地址
组织 机构 代码	组织 机构 代码
报到证 迁往 单位 ( 报到证 抬头 )	报到证 迁往 单位 ( 报到证 抬头 )
报到证 迁往 单位 所属 省份	报到证 迁往 单位 所属 省份
报到证 迁往 单位 所在地	报到证 迁往 单位 所在地
是否 接受 档案	是否 接受 档案
档案 转递 地址	档案 转递 地址
档案 转递 单位名称	档案 转递 单位名称
是否 接受 户口	深圳 落户
公司 可以 接收 户口 吗	深圳 落户
深圳 可以 落户 吗	深圳 落户
怎么 在 深圳 落户	深圳 落户
怎么 落户 深圳	深圳 落户
户口 迁移 地址	户口 迁移 地址
党组织 关系 怎么 办理	党组织 关系 调转
介绍信 抬头	党组织 关系 调转
接收 党组织 关系 吗	党组织 关系 调转
可以 提前 入职 吗	校招 提前 入职 怎么 处理
入职 时间	校招 提前 入职 怎么 处理
入职 资料	校招 提前 入职 怎么 处理
海外 入职 时间	校招 提前 入职 怎么 处理
校招 薪资 情况	校招 薪资 情况
薪资 是 税前 还是 税后	薪资 是 税前 还是 税后
有 住房补贴 吗	有 住房补贴 吗
有 宿舍 吗	员工 宿舍
提供 宿舍 吗	员工 宿舍
