顺丰科技	顺丰科技简介
顺丰科技有限公司	顺丰科技简介
顺丰科技是家什么样的公司	顺丰科技简介
顺丰科技是什么公司	顺丰科技简介
顺丰科技资料	顺丰科技简介
顺丰科技简介	顺丰科技简介
顺丰科技介绍	顺丰科技简介
顺丰科技和顺丰速运的关系	顺丰科技和顺丰速运的关系
顺丰科技属于顺丰集团吗	顺丰科技和顺丰速运的关系
顺丰科技和顺丰速运有啥关系	顺丰科技和顺丰速运的关系
顺丰科技与顺丰咨询	顺丰咨询是做什么的
顺丰咨询是做什么的	顺丰咨询是做什么的
顺丰科技公司在哪儿	顺丰科技地址
顺丰科技在哪上班	顺丰科技地址
顺丰科技办公环境	顺丰科技地址
顺丰科技办公地点	顺丰科技地址
工作地点	顺丰科技地址
上班时间	弹性工作制
下班时间	弹性工作制
工作时间	弹性工作制
弹性工作制	弹性工作制
休假制度	休假制度
休假安排	休假制度
假期情况	休假制度
顺丰科技公司附近地铁、公交	公司附近交通
顺丰科技公司交通便利吗	公司附近交通
顺丰科技公司最近的地铁站	公司附近交通
顺丰科技人员规模	顺丰科技公司规模
顺丰科技公司规模	顺丰科技公司规模
顺丰科技团队规模	顺丰科技公司规模
顺丰科技研发团队	顺丰科技公司规模
顺丰科技规模	顺丰科技公司规模
顺丰科技目前有多少人	顺丰科技公司规模
顺丰科技有多少技术人员	顺丰科技公司规模
顺丰科技怎么样	顺丰科技实力
顺丰科技实力	顺丰科技实力
顺丰科技如何	顺丰科技实力
顺丰科技的技术水平	顺丰科技实力
顺丰科技研发实力	顺丰科技实力
顺丰科技业务	顺丰科技实力
顺丰科技发展	顺丰科技发展
顺丰科技的前景	顺丰科技发展
顺丰科技未来发展	顺丰科技发展
顺丰科技ceo	顺丰科技总裁
顺丰科技总裁	顺丰科技总裁
田民	顺丰科技总裁
顺丰科技上市了吗	顺丰科技股票
顺丰科技股票	顺丰科技股票
顺丰科技员工配股吗	顺丰科技股票
顺丰科技在深圳工资	顺丰科技薪资待遇
顺丰科技薪资	顺丰科技薪资待遇
顺丰科技待遇怎么样	顺丰科技薪资待遇
顺丰科技级别与薪资	顺丰科技薪资待遇
薪酬福利	顺丰科技薪资待遇
顺丰科技项目奖金	顺丰科技年终奖
顺丰科技年终奖多吗	顺丰科技年终奖
顺丰科技年终奖	顺丰科技年终奖
顺丰科技年终奖能发多少	顺丰科技年终奖
智慧物流是什么	顺丰科技智慧物流
顺丰科技智慧物流	顺丰科技智慧物流
顺丰科技智慧物流有些方面	顺丰科技智慧物流
顺丰科技文化氛围	顺丰科技文化
顺丰科技工作氛围	顺丰科技文化
顺丰科技文化	顺丰科技文化
顺丰科技文化价值观	顺丰科技文化
顺丰科技企业价值观	顺丰科技文化
是否需要经常加班	加班情况
加班严重吗	加班情况
需要经常加班吗	加班情况
几点下班	加班情况
公司签多长时间的劳动合同？	合同年限
合同签多久	合同年限
合同几年	合同年限
合同年限	合同年限
公司社保和公积金	社保和公积金
五险一金缴纳标准	社保和公积金
公司的调薪机制是怎样的？	调薪
校招启动时间	校招开始时间
校招开始时间	校招开始时间
海外校招开始时间及行程安排	海外校招
海外招聘行程	海外校招
海外校招城市	海外校招
校招结束时间	校招结束时间
顺丰科技招聘公众号	顺丰科技微信公众号
校招微信公众号是什么	顺丰科技微信公众号
校招网站	顺丰科技招聘网站
校招官网	顺丰科技招聘网站
顺丰科技招聘网站	顺丰科技招聘网站
顺丰科技校招联系人	校招工作人员邮箱
怎么联系校招工作人员	校招工作人员邮箱
校招工作人员联系方式	校招工作人员邮箱
校园招聘行程	校园招聘行程安排
校招会去哪些城市	校园招聘行程安排
校园招聘城市	校园招聘行程安排
校招会去哪些地方	校园招聘行程安排
校招线路和时间	校园招聘行程安排
今年的校招路线安排	校园招聘行程安排
校招招聘职位有哪些	校招岗位
校招所有岗位	校招岗位
校招岗位有哪些	校招岗位
校招有哪些岗位	校招岗位
校招岗位招聘多少人	校招招聘人数
校招岗位招聘人数	校招招聘人数
校招岗位需求数量	校招招聘人数
今年校招招多少人	校招招聘人数
这个岗位什么专业可以申请	校园招聘岗位专业要求
岗位是否限定专业	校园招聘岗位专业要求
非相关专业可以申请吗	校园招聘岗位专业要求
岗位专业要求	校园招聘岗位专业要求
校招学历要求	岗位学历要求
三本学历有影响吗	岗位学历要求
非宣讲院校学生影响吗	岗位学历要求
非211/985院校可以投递吗	岗位学历要求
双非学校有影响吗	岗位学历要求
双非学校有机会吗	岗位学历要求
是否接受非应届生投递	校招非应届可以投递吗
非应届生可以投递吗	校招非应届可以投递吗
是否接受往届生投递	校招非应届可以投递吗
非应届生可以申请吗	校招非应届可以投递吗
应届生毕业时间	应届生界定
海外应届生毕业时间	应届生界定
怎么界定应届生	应届生界定
什么时候毕业算应届生	应届生界定
是否有性别歧视	岗位性别歧视
是否有限定性别	岗位性别歧视
某些岗位是否不招女生	岗位性别歧视
某岗位是否只招男生	岗位性别歧视
校园招聘宣讲院校	校园招聘宣讲院校行程安排
校招会在哪些院校宣讲	校园招聘宣讲院校行程安排
宣讲会时间安排	校园招聘宣讲院校行程安排
宣讲会行程	校园招聘宣讲院校行程安排
宣讲会地点	校园招聘宣讲院校行程安排
宣讲会现场是否接收简历	宣讲会现场是否接收简历
宣讲会可以投简历吗	宣讲会现场是否接收简历
宣讲会现场收简历吗	宣讲会现场是否接收简历
简历投递地址	校招网申地址
简历投递网站	校招网申地址
校招网申地址	校招网申地址
校招网申链接	校招网申地址
校招怎么网申	校招网申地址
校招怎么投递简历	校招网申地址
校招网申途径	校招网申地址
网申通道	校招网申地址
校招简历投递渠道	校招网申地址
校招简历投递途径	校招网申地址
校招可以投递几个岗位	校招岗位投递数量
校招岗位投递数量	校招岗位投递数量
校招岗位数量有限制吗	校招岗位投递数量
最多可以申请几个岗位	校招岗位投递数量
一个人可以申几个岗位	校招岗位投递数量
可以同时投递几个岗位	校招岗位投递数量
可以申请几个职位	校招岗位投递数量
网申开始时间	校招网申开始时间
什么时候可以网申	校招网申开始时间
网申什么时候结束	校招网申结束时间
简历投递结束日期	校招网申结束时间
网申截止时间	校招网申结束时间
校招还可以投简历吗	校招网申结束时间
简历投递截止日期	校招网申结束时间
校招网申截止日期	校招网申结束时间
还可以网申吗	校招网申结束时间
还可以投简历吗	校招网申结束时间
网申测评成绩	网申测评成绩
在线测评成绩影响简历筛选吗	网申测评成绩
网申测评对面试有影响吗	网申测评成绩
必须做网申测评吗	网申测评成绩
网申测评成绩重要吗	网申测评成绩
网申遇到问题怎么办	校招网申遇到问题反馈渠道
网申提交不了怎么办	校招网申遇到问题反馈渠道
网申不了怎么办	校招网申遇到问题反馈渠道
测评提交不了	校招网申遇到问题反馈渠道
有问题怎么反馈	校招网申遇到问题反馈渠道
简历筛选的标准	简历筛选的标准
简历筛选会看专业吗	简历筛选的标准
简历筛选会有专业限制吗	简历筛选的标准
简历筛选比例	简历筛选比例
简历筛选什么时候结束	简历筛选什么时候出结果
简历筛选什么时候出结果	简历筛选什么时候出结果
什么岗位需要笔试	校招笔试岗位
需要参加笔试的岗位	校招笔试岗位
校招笔试岗位有哪些	校招笔试岗位
职能类岗位需要笔试吗	校招笔试岗位
校招笔试内容	校招笔试的内容
校招笔试考什么	校招笔试的内容
笔试难吗	校招笔试的内容
笔试时间	笔试时间
笔试通知什么时候发	笔试时间
笔试方式	校招笔试方式
笔试是在线上还是线下	校招笔试方式
笔试结果什么时候出	笔试结果反馈时间
笔试反馈时间	笔试结果反馈时间
面试流程	校园招聘的面试流程是什么
面试一共有几轮	校园招聘的面试流程是什么
校招一共面几轮	校园招聘的面试流程是什么
错过笔试，可以面试吗	校招接受霸面吗？
忘记笔试可以面试吗	校招接受霸面吗？
忘记笔试可以霸面吗	校招接受霸面吗？
可以霸面吗	校招接受霸面吗？
接受霸面吗	校招接受霸面吗？
面试通知什么时候发	面试通知时间
什么时候给面试通知	面试通知时间
开始面试了吗	面试通知时间
校招面试要携带的资料	面试环节还需要提供哪些资料、证件?
校招面试要带什么	面试环节还需要提供哪些资料、证件?
面试资料	面试环节还需要提供哪些资料、证件?
可以更改面试地点吗	校招面试地点
可以换面试城市吗	校招面试地点
面试结果什么时候给	面试结果什么时候通知
什么时候有面试结果	面试结果什么时候通知
如何查询面试结果	面试结果什么时候通知
面试不通过会通知吗	面试结果什么时候通知
面试通过后几天给通知	面试结果什么时候通知
校招面试结束了吗	面试结果什么时候通知
什么时候给面试通知	面试结果什么时候通知
什么时候发offer	校招offer时间
offer发了吗	校招offer时间
毁约流程	毁约流程
签三方后，违约怎么处理	毁约流程
offer沟通会必须参加吗	毁约流程
三方邮寄地址	公司联系人及电话、地址(三方接收人)
三方接收人	公司联系人及电话、地址(三方接收人)
三方什么时候寄回	三方寄回时间
三方寄回时间	三方寄回时间
公司全称	公司全称
公司地址	顺丰科技地址
顺丰科技地址	顺丰科技地址
组织机构代码	组织机构代码
报到证迁往单位(报到证抬头)	报到证迁往单位(报到证抬头)
报到证迁往单位所属省份	报到证迁往单位所属省份
报到证迁往单位所在地	报到证迁往单位所在地
是否接受档案	是否接受档案
档案转递地址	档案转递地址
档案转递单位名称	档案转递单位名称
是否接受户口	深圳落户
公司可以接收户口吗	深圳落户
深圳可以落户吗	深圳落户
怎么在深圳落户	深圳落户
怎么落户深圳	深圳落户
户口迁移地址	户口迁移地址
党组织关系怎么办理	党组织关系调转
介绍信抬头	党组织关系调转
接收党组织关系吗	党组织关系调转
可以提前入职吗	校招提前入职怎么处理
入职时间	校招提前入职怎么处理
入职资料	校招提前入职怎么处理
海外入职时间	校招提前入职怎么处理
校招薪资情况	校招薪资情况
薪资是税前还是税后	薪资是税前还是税后
有住房补贴吗	有住房补贴吗
有宿舍吗	员工宿舍
提供宿舍吗	员工宿舍
